###|################
|------------------#
#---------+--------#
#------------------#
#------------------#
#------------------#
#------------------|
#|##################