###|######+#########
|------------------#
#------------------#
#------------------#
#------------------#
#------------------#
#------------------|
#|##################