###|########
|----------#
#----#####-#
#----#-!-#-#
#----#-----#
#----#######
#----------|
#|##########