#|##########
#----------|
########-###
########-###
########---#
########---#
|----------#
########---#
##########-#
##########-#
##########|#