#####|######
#####-######
#####-######
###------###
###------###
|----------|
###------###
###------###
#####-######
#####-######
#####|######