#####|######
####----####
####----####
#----##----|
#-#######--#
#-######--##
|-#####--###
#--###--####
##--#--#####
###---######
####|#######