###|########
|----#######
####-#######
####-----###
####-###-###
####-###-###
####-###-###
####-###-###
####-###-###
#----------|
#|##########